######################
#	 #S           ##
# ########### ########
#    #              ##
# # ### ######### ####
# #     ######      ##
# #######  E####### ##
#   # ### #### #### ##
# ### ### #### #### ##
# ### ### #### #### ##
#                    #
######################
